"filename", "language", "PHP", "HTML", "Markdown", "JSON", "comment", "blank", "total"
"c:\xampp\htdocs\codei4\application\cache\index.html", "HTML", 0, 9, 0, 0, 0, 3, 12
"c:\xampp\htdocs\codei4\application\config\autoload.php", "PHP", 9, 0, 0, 0, 118, 8, 135
"c:\xampp\htdocs\codei4\application\config\config.php", "PHP", 50, 0, 0, 0, 443, 31, 524
"c:\xampp\htdocs\codei4\application\config\constants.php", "PHP", 25, 0, 0, 0, 56, 5, 86
"c:\xampp\htdocs\codei4\application\config\database.php", "PHP", 25, 0, 0, 0, 69, 3, 97
"c:\xampp\htdocs\codei4\application\config\doctypes.php", "PHP", 23, 0, 0, 0, 0, 2, 25
"c:\xampp\htdocs\codei4\application\config\foreign_chars.php", "PHP", 105, 0, 0, 0, 8, 2, 115
"c:\xampp\htdocs\codei4\application\config\hooks.php", "PHP", 2, 0, 0, 0, 10, 2, 14
"c:\xampp\htdocs\codei4\application\config\index.html", "HTML", 0, 9, 0, 0, 0, 3, 12
"c:\xampp\htdocs\codei4\application\config\memcached.php", "PHP", 9, 0, 0, 0, 9, 2, 20
"c:\xampp\htdocs\codei4\application\config\migration.php", "PHP", 8, 0, 0, 0, 70, 7, 85
"c:\xampp\htdocs\codei4\application\config\mimes.php", "PHP", 175, 0, 0, 0, 8, 2, 185
"c:\xampp\htdocs\codei4\application\config\profiler.php", "PHP", 2, 0, 0, 0, 11, 2, 15
"c:\xampp\htdocs\codei4\application\config\routes.php", "PHP", 12, 0, 0, 0, 48, 7, 67
"c:\xampp\htdocs\codei4\application\config\smileys.php", "PHP", 47, 0, 0, 0, 13, 5, 65
"c:\xampp\htdocs\codei4\application\config\user_agents.php", "PHP", 176, 0, 0, 0, 30, 11, 217
"c:\xampp\htdocs\codei4\application\controllers\Image_detail.php", "PHP", 146, 0, 0, 0, 3, 28, 177
"c:\xampp\htdocs\codei4\application\controllers\Welcome.php", "PHP", 8, 0, 0, 0, 15, 3, 26
"c:\xampp\htdocs\codei4\application\controllers\index.html", "HTML", 0, 9, 0, 0, 0, 3, 12
"c:\xampp\htdocs\codei4\application\core\index.html", "HTML", 0, 9, 0, 0, 0, 3, 12
"c:\xampp\htdocs\codei4\application\helpers\index.html", "HTML", 0, 9, 0, 0, 0, 3, 12
"c:\xampp\htdocs\codei4\application\hooks\index.html", "HTML", 0, 9, 0, 0, 0, 3, 12
"c:\xampp\htdocs\codei4\application\index.html", "HTML", 0, 9, 0, 0, 0, 3, 12
"c:\xampp\htdocs\codei4\application\language\english\index.html", "HTML", 0, 9, 0, 0, 0, 3, 12
"c:\xampp\htdocs\codei4\application\language\index.html", "HTML", 0, 9, 0, 0, 0, 3, 12
"c:\xampp\htdocs\codei4\application\libraries\index.html", "HTML", 0, 9, 0, 0, 0, 3, 12
"c:\xampp\htdocs\codei4\application\logs\index.html", "HTML", 0, 9, 0, 0, 0, 3, 12
"c:\xampp\htdocs\codei4\application\models\Image_action.php", "PHP", 32, 0, 0, 0, 1, 7, 40
"c:\xampp\htdocs\codei4\application\models\index.html", "HTML", 0, 9, 0, 0, 0, 3, 12
"c:\xampp\htdocs\codei4\application\third_party\index.html", "HTML", 0, 9, 0, 0, 0, 3, 12
"c:\xampp\htdocs\codei4\application\views\Add_Image.php", "PHP", 102, 0, 0, 0, 2, 19, 123
"c:\xampp\htdocs\codei4\application\views\errors\cli\error_404.php", "PHP", 7, 0, 0, 0, 0, 1, 8
"c:\xampp\htdocs\codei4\application\views\errors\cli\error_db.php", "PHP", 7, 0, 0, 0, 0, 1, 8
"c:\xampp\htdocs\codei4\application\views\errors\cli\error_exception.php", "PHP", 16, 0, 0, 0, 0, 6, 22
"c:\xampp\htdocs\codei4\application\views\errors\cli\error_general.php", "PHP", 7, 0, 0, 0, 0, 1, 8
"c:\xampp\htdocs\codei4\application\views\errors\cli\error_php.php", "PHP", 16, 0, 0, 0, 0, 6, 22
"c:\xampp\htdocs\codei4\application\views\errors\cli\index.html", "HTML", 0, 9, 0, 0, 0, 3, 12
"c:\xampp\htdocs\codei4\application\views\errors\html\error_404.php", "PHP", 57, 0, 0, 0, 0, 7, 64
"c:\xampp\htdocs\codei4\application\views\errors\html\error_db.php", "PHP", 57, 0, 0, 0, 0, 7, 64
"c:\xampp\htdocs\codei4\application\views\errors\html\error_exception.php", "PHP", 22, 0, 0, 0, 0, 10, 32
"c:\xampp\htdocs\codei4\application\views\errors\html\error_general.php", "PHP", 57, 0, 0, 0, 0, 7, 64
"c:\xampp\htdocs\codei4\application\views\errors\html\error_php.php", "PHP", 22, 0, 0, 0, 0, 11, 33
"c:\xampp\htdocs\codei4\application\views\errors\html\index.html", "HTML", 0, 9, 0, 0, 0, 3, 12
"c:\xampp\htdocs\codei4\application\views\errors\index.html", "HTML", 0, 9, 0, 0, 0, 3, 12
"c:\xampp\htdocs\codei4\application\views\index.html", "HTML", 0, 9, 0, 0, 0, 3, 12
"c:\xampp\htdocs\codei4\application\views\welcome_message.php", "PHP", 73, 0, 0, 0, 0, 16, 89
"c:\xampp\htdocs\codei4\autoload.php", "PHP", 9, 0, 0, 0, 118, 8, 135
"c:\xampp\htdocs\codei4\composer.json", "JSON", 0, 0, 0, 23, 0, 1, 24
"c:\xampp\htdocs\codei4\contributing.md", "Markdown", 0, 0, 57, 0, 0, 37, 94
"c:\xampp\htdocs\codei4\index.php", "PHP", 119, 0, 0, 0, 167, 30, 316
"c:\xampp\htdocs\codei4\routes.php", "PHP", 11, 0, 0, 0, 55, 19, 85
"c:\xampp\htdocs\codei4\system\core\Benchmark.php", "PHP", 29, 0, 0, 0, 93, 12, 134
"c:\xampp\htdocs\codei4\system\core\CodeIgniter.php", "PHP", 230, 0, 0, 0, 272, 58, 560
"c:\xampp\htdocs\codei4\system\core\Common.php", "PHP", 443, 0, 0, 0, 302, 105, 850
"c:\xampp\htdocs\codei4\system\core\Config.php", "PHP", 182, 0, 0, 0, 151, 47, 380
"c:\xampp\htdocs\codei4\system\core\Controller.php", "PHP", 21, 0, 0, 0, 73, 10, 104
"c:\xampp\htdocs\codei4\system\core\Exceptions.php", "PHP", 137, 0, 0, 0, 110, 28, 275
"c:\xampp\htdocs\codei4\system\core\Hooks.php", "PHP", 120, 0, 0, 0, 112, 35, 267
"c:\xampp\htdocs\codei4\system\core\Input.php", "PHP", 431, 0, 0, 0, 352, 113, 896
"c:\xampp\htdocs\codei4\system\core\Lang.php", "PHP", 93, 0, 0, 0, 85, 26, 204
"c:\xampp\htdocs\codei4\system\core\Loader.php", "PHP", 724, 0, 0, 0, 507, 185, 1416
"c:\xampp\htdocs\codei4\system\core\Log.php", "PHP", 118, 0, 0, 0, 138, 41, 297
"c:\xampp\htdocs\codei4\system\core\Model.php", "PHP", 9, 0, 0, 0, 63, 5, 77
"c:\xampp\htdocs\codei4\system\core\Output.php", "PHP", 391, 0, 0, 0, 326, 126, 843
"c:\xampp\htdocs\codei4\system\core\Router.php", "PHP", 224, 0, 0, 0, 225, 67, 516
"c:\xampp\htdocs\codei4\system\core\Security.php", "PHP", 489, 0, 0, 0, 478, 125, 1092
"c:\xampp\htdocs\codei4\system\core\URI.php", "PHP", 269, 0, 0, 0, 294, 81, 644
"c:\xampp\htdocs\codei4\system\core\Utf8.php", "PHP", 57, 0, 0, 0, 93, 15, 165
"c:\xampp\htdocs\codei4\system\core\compat\hash.php", "PHP", 156, 0, 0, 0, 74, 25, 255
"c:\xampp\htdocs\codei4\system\core\compat\index.html", "HTML", 0, 9, 0, 0, 0, 3, 12
"c:\xampp\htdocs\codei4\system\core\compat\mbstring.php", "PHP", 50, 0, 0, 0, 87, 13, 150
"c:\xampp\htdocs\codei4\system\core\compat\password.php", "PHP", 136, 0, 0, 0, 89, 27, 252
"c:\xampp\htdocs\codei4\system\core\compat\standard.php", "PHP", 102, 0, 0, 0, 65, 16, 183
"c:\xampp\htdocs\codei4\system\core\index.html", "HTML", 0, 9, 0, 0, 0, 3, 12
"c:\xampp\htdocs\codei4\system\database\DB.php", "PHP", 117, 0, 0, 0, 80, 22, 219
"c:\xampp\htdocs\codei4\system\database\DB_cache.php", "PHP", 84, 0, 0, 0, 106, 32, 222
"c:\xampp\htdocs\codei4\system\database\DB_driver.php", "PHP", 872, 0, 0, 0, 844, 270, 1986
"c:\xampp\htdocs\codei4\system\database\DB_forge.php", "PHP", 542, 0, 0, 0, 347, 145, 1034
"c:\xampp\htdocs\codei4\system\database\DB_query_builder.php", "PHP", 1338, 0, 0, 0, 1076, 395, 2809
"c:\xampp\htdocs\codei4\system\database\DB_result.php", "PHP", 281, 0, 0, 0, 291, 94, 666
"c:\xampp\htdocs\codei4\system\database\DB_utility.php", "PHP", 216, 0, 0, 0, 152, 57, 425
"c:\xampp\htdocs\codei4\system\database\drivers\cubrid\cubrid_driver.php", "PHP", 156, 0, 0, 0, 193, 57, 406
"c:\xampp\htdocs\codei4\system\database\drivers\cubrid\cubrid_forge.php", "PHP", 103, 0, 0, 0, 103, 25, 231
"c:\xampp\htdocs\codei4\system\database\drivers\cubrid\cubrid_result.php", "PHP", 52, 0, 0, 0, 106, 20, 178
"c:\xampp\htdocs\codei4\system\database\drivers\cubrid\cubrid_utility.php", "PHP", 16, 0, 0, 0, 58, 6, 80
"c:\xampp\htdocs\codei4\system\database\drivers\cubrid\index.html", "HTML", 0, 9, 0, 0, 0, 3, 12
"c:\xampp\htdocs\codei4\system\database\drivers\ibase\ibase_driver.php", "PHP", 150, 0, 0, 0, 211, 53, 414
"c:\xampp\htdocs\codei4\system\database\drivers\ibase\ibase_forge.php", "PHP", 105, 0, 0, 0, 118, 29, 252
"c:\xampp\htdocs\codei4\system\database\drivers\ibase\ibase_result.php", "PHP", 53, 0, 0, 0, 89, 20, 162
"c:\xampp\htdocs\codei4\system\database\drivers\ibase\ibase_utility.php", "PHP", 14, 0, 0, 0, 50, 6, 70
"c:\xampp\htdocs\codei4\system\database\drivers\ibase\index.html", "HTML", 0, 9, 0, 0, 0, 3, 12
"c:\xampp\htdocs\codei4\system\database\drivers\index.html", "HTML", 0, 9, 0, 0, 0, 3, 12
"c:\xampp\htdocs\codei4\system\database\drivers\mssql\index.html", "HTML", 0, 9, 0, 0, 0, 3, 12
"c:\xampp\htdocs\codei4\system\database\drivers\mssql\mssql_driver.php", "PHP", 198, 0, 0, 0, 248, 73, 519
"c:\xampp\htdocs\codei4\system\database\drivers\mssql\mssql_forge.php", "PHP", 51, 0, 0, 0, 86, 15, 152
"c:\xampp\htdocs\codei4\system\database\drivers\mssql\mssql_result.php", "PHP", 67, 0, 0, 0, 108, 24, 199
"c:\xampp\htdocs\codei4\system\database\drivers\mssql\mssql_utility.php", "PHP", 10, 0, 0, 0, 62, 6, 78
"c:\xampp\htdocs\codei4\system\database\drivers\mysql\index.html", "HTML", 0, 9, 0, 0, 0, 3, 12
"c:\xampp\htdocs\codei4\system\database\drivers\mysql\mysql_driver.php", "PHP", 191, 0, 0, 0, 233, 71, 495
"c:\xampp\htdocs\codei4\system\database\drivers\mysql\mysql_forge.php", "PHP", 118, 0, 0, 0, 96, 30, 244
"c:\xampp\htdocs\codei4\system\database\drivers\mysql\mysql_result.php", "PHP", 62, 0, 0, 0, 115, 23, 200
"c:\xampp\htdocs\codei4\system\database\drivers\mysql\mysql_utility.php", "PHP", 93, 0, 0, 0, 87, 32, 212
"c:\xampp\htdocs\codei4\system\database\drivers\mysqli\index.html", "HTML", 0, 9, 0, 0, 0, 3, 12
"c:\xampp\htdocs\codei4\system\database\drivers\mysqli\mysqli_driver.php", "PHP", 237, 0, 0, 0, 237, 73, 547
"c:\xampp\htdocs\codei4\system\database\drivers\mysqli\mysqli_forge.php", "PHP", 118, 0, 0, 0, 98, 29, 245
"c:\xampp\htdocs\codei4\system\database\drivers\mysqli\mysqli_result.php", "PHP", 91, 0, 0, 0, 119, 23, 233
"c:\xampp\htdocs\codei4\system\database\drivers\mysqli\mysqli_utility.php", "PHP", 91, 0, 0, 0, 89, 32, 212
"c:\xampp\htdocs\codei4\system\database\drivers\oci8\index.html", "HTML", 0, 9, 0, 0, 0, 3, 12
"c:\xampp\htdocs\codei4\system\database\drivers\oci8\oci8_driver.php", "PHP", 296, 0, 0, 0, 316, 90, 702
"c:\xampp\htdocs\codei4\system\database\drivers\oci8\oci8_forge.php", "PHP", 74, 0, 0, 0, 101, 20, 195
"c:\xampp\htdocs\codei4\system\database\drivers\oci8\oci8_result.php", "PHP", 82, 0, 0, 0, 118, 30, 230
"c:\xampp\htdocs\codei4\system\database\drivers\oci8\oci8_utility.php", "PHP", 9, 0, 0, 0, 55, 5, 69
"c:\xampp\htdocs\codei4\system\database\drivers\odbc\index.html", "HTML", 0, 9, 0, 0, 0, 3, 12
"c:\xampp\htdocs\codei4\system\database\drivers\odbc\odbc_driver.php", "PHP", 159, 0, 0, 0, 209, 58, 426
"c:\xampp\htdocs\codei4\system\database\drivers\odbc\odbc_forge.php", "PHP", 10, 0, 0, 0, 69, 8, 87
"c:\xampp\htdocs\codei4\system\database\drivers\odbc\odbc_result.php", "PHP", 117, 0, 0, 0, 120, 32, 269
"c:\xampp\htdocs\codei4\system\database\drivers\odbc\odbc_utility.php", "PHP", 8, 0, 0, 0, 52, 4, 64
"c:\xampp\htdocs\codei4\system\database\drivers\pdo\index.html", "HTML", 0, 9, 0, 0, 0, 3, 12
"c:\xampp\htdocs\codei4\system\database\drivers\pdo\pdo_driver.php", "PHP", 127, 0, 0, 0, 162, 41, 330
"c:\xampp\htdocs\codei4\system\database\drivers\pdo\pdo_forge.php", "PHP", 6, 0, 0, 0, 55, 5, 66
"c:\xampp\htdocs\codei4\system\database\drivers\pdo\pdo_result.php", "PHP", 78, 0, 0, 0, 99, 22, 199
"c:\xampp\htdocs\codei4\system\database\drivers\pdo\pdo_utility.php", "PHP", 8, 0, 0, 0, 52, 4, 64
"c:\xampp\htdocs\codei4\system\database\drivers\pdo\subdrivers\index.html", "HTML", 0, 9, 0, 0, 0, 3, 12
"c:\xampp\htdocs\codei4\system\database\drivers\pdo\subdrivers\pdo_4d_driver.php", "PHP", 55, 0, 0, 0, 123, 23, 201
"c:\xampp\htdocs\codei4\system\database\drivers\pdo\subdrivers\pdo_4d_forge.php", "PHP", 75, 0, 0, 0, 121, 22, 218
"c:\xampp\htdocs\codei4\system\database\drivers\pdo\subdrivers\pdo_cubrid_driver.php", "PHP", 64, 0, 0, 0, 119, 27, 210
"c:\xampp\htdocs\codei4\system\database\drivers\pdo\subdrivers\pdo_cubrid_forge.php", "PHP", 103, 0, 0, 0, 103, 25, 231
"c:\xampp\htdocs\codei4\system\database\drivers\pdo\subdrivers\pdo_dblib_driver.php", "PHP", 146, 0, 0, 0, 161, 47, 354
"c:\xampp\htdocs\codei4\system\database\drivers\pdo\subdrivers\pdo_dblib_forge.php", "PHP", 51, 0, 0, 0, 84, 15, 150
"c:\xampp\htdocs\codei4\system\database\drivers\pdo\subdrivers\pdo_firebird_driver.php", "PHP", 104, 0, 0, 0, 146, 30, 280
"c:\xampp\htdocs\codei4\system\database\drivers\pdo\subdrivers\pdo_firebird_forge.php", "PHP", 103, 0, 0, 0, 108, 27, 238
"c:\xampp\htdocs\codei4\system\database\drivers\pdo\subdrivers\pdo_ibm_driver.php", "PHP", 98, 0, 0, 0, 117, 30, 245
"c:\xampp\htdocs\codei4\system\database\drivers\pdo\subdrivers\pdo_ibm_forge.php", "PHP", 45, 0, 0, 0, 94, 16, 155
"c:\xampp\htdocs\codei4\system\database\drivers\pdo\subdrivers\pdo_informix_driver.php", "PHP", 142, 0, 0, 0, 135, 33, 310
"c:\xampp\htdocs\codei4\system\database\drivers\pdo\subdrivers\pdo_informix_forge.php", "PHP", 56, 0, 0, 0, 93, 15, 164
"c:\xampp\htdocs\codei4\system\database\drivers\pdo\subdrivers\pdo_mysql_driver.php", "PHP", 168, 0, 0, 0, 162, 50, 380
"c:\xampp\htdocs\codei4\system\database\drivers\pdo\subdrivers\pdo_mysql_forge.php", "PHP", 120, 0, 0, 0, 106, 31, 257
"c:\xampp\htdocs\codei4\system\database\drivers\pdo\subdrivers\pdo_oci_driver.php", "PHP", 138, 0, 0, 0, 145, 44, 327
"c:\xampp\htdocs\codei4\system\database\drivers\pdo\subdrivers\pdo_oci_forge.php", "PHP", 72, 0, 0, 0, 95, 17, 184
"c:\xampp\htdocs\codei4\system\database\drivers\pdo\subdrivers\pdo_odbc_driver.php", "PHP", 81, 0, 0, 0, 120, 29, 230
"c:\xampp\htdocs\codei4\system\database\drivers\pdo\subdrivers\pdo_odbc_forge.php", "PHP", 8, 0, 0, 0, 57, 6, 71
"c:\xampp\htdocs\codei4\system\database\drivers\pdo\subdrivers\pdo_pgsql_driver.php", "PHP", 155, 0, 0, 0, 177, 53, 385
"c:\xampp\htdocs\codei4\system\database\drivers\pdo\subdrivers\pdo_pgsql_forge.php", "PHP", 96, 0, 0, 0, 92, 23, 211
"c:\xampp\htdocs\codei4\system\database\drivers\pdo\subdrivers\pdo_sqlite_driver.php", "PHP", 73, 0, 0, 0, 113, 28, 214
"c:\xampp\htdocs\codei4\system\database\drivers\pdo\subdrivers\pdo_sqlite_forge.php", "PHP", 82, 0, 0, 0, 130, 27, 239
"c:\xampp\htdocs\codei4\system\database\drivers\pdo\subdrivers\pdo_sqlsrv_driver.php", "PHP", 161, 0, 0, 0, 157, 52, 370
"c:\xampp\htdocs\codei4\system\database\drivers\pdo\subdrivers\pdo_sqlsrv_forge.php", "PHP", 51, 0, 0, 0, 84, 15, 150
"c:\xampp\htdocs\codei4\system\database\drivers\postgre\index.html", "HTML", 0, 9, 0, 0, 0, 3, 12
"c:\xampp\htdocs\codei4\system\database\drivers\postgre\postgre_driver.php", "PHP", 264, 0, 0, 0, 268, 88, 620
"c:\xampp\htdocs\codei4\system\database\drivers\postgre\postgre_forge.php", "PHP", 95, 0, 0, 0, 89, 22, 206
"c:\xampp\htdocs\codei4\system\database\drivers\postgre\postgre_result.php", "PHP", 55, 0, 0, 0, 108, 20, 183
"c:\xampp\htdocs\codei4\system\database\drivers\postgre\postgre_utility.php", "PHP", 10, 0, 0, 0, 63, 6, 79
"c:\xampp\htdocs\codei4\system\database\drivers\sqlite3\index.html", "HTML", 0, 9, 0, 0, 0, 3, 12
"c:\xampp\htdocs\codei4\system\database\drivers\sqlite3\sqlite3_driver.php", "PHP", 121, 0, 0, 0, 179, 45, 345
"c:\xampp\htdocs\codei4\system\database\drivers\sqlite3\sqlite3_forge.php", "PHP", 80, 0, 0, 0, 121, 25, 226
"c:\xampp\htdocs\codei4\system\database\drivers\sqlite3\sqlite3_result.php", "PHP", 70, 0, 0, 0, 102, 23, 195
"c:\xampp\htdocs\codei4\system\database\drivers\sqlite3\sqlite3_utility.php", "PHP", 8, 0, 0, 0, 50, 4, 62
"c:\xampp\htdocs\codei4\system\database\drivers\sqlite\index.html", "HTML", 0, 9, 0, 0, 0, 3, 12
"c:\xampp\htdocs\codei4\system\database\drivers\sqlite\sqlite_driver.php", "PHP", 105, 0, 0, 0, 181, 45, 331
"c:\xampp\htdocs\codei4\system\database\drivers\sqlite\sqlite_forge.php", "PHP", 67, 0, 0, 0, 117, 22, 206
"c:\xampp\htdocs\codei4\system\database\drivers\sqlite\sqlite_result.php", "PHP", 47, 0, 0, 0, 100, 18, 165
"c:\xampp\htdocs\codei4\system\database\drivers\sqlite\sqlite_utility.php", "PHP", 8, 0, 0, 0, 50, 4, 62
"c:\xampp\htdocs\codei4\system\database\drivers\sqlsrv\index.html", "HTML", 0, 9, 0, 0, 0, 3, 12
"c:\xampp\htdocs\codei4\system\database\drivers\sqlsrv\sqlsrv_driver.php", "PHP", 223, 0, 0, 0, 246, 75, 544
"c:\xampp\htdocs\codei4\system\database\drivers\sqlsrv\sqlsrv_forge.php", "PHP", 51, 0, 0, 0, 84, 15, 150
"c:\xampp\htdocs\codei4\system\database\drivers\sqlsrv\sqlsrv_result.php", "PHP", 61, 0, 0, 0, 109, 24, 194
"c:\xampp\htdocs\codei4\system\database\drivers\sqlsrv\sqlsrv_utility.php", "PHP", 10, 0, 0, 0, 61, 7, 78
"c:\xampp\htdocs\codei4\system\database\index.html", "HTML", 0, 9, 0, 0, 0, 3, 12
"c:\xampp\htdocs\codei4\system\fonts\index.html", "HTML", 0, 9, 0, 0, 0, 3, 12
"c:\xampp\htdocs\codei4\system\helpers\array_helper.php", "PHP", 29, 0, 0, 0, 76, 11, 116
"c:\xampp\htdocs\codei4\system\helpers\captcha_helper.php", "PHP", 204, 0, 0, 0, 101, 37, 342
"c:\xampp\htdocs\codei4\system\helpers\cookie_helper.php", "PHP", 25, 0, 0, 0, 81, 8, 114
"c:\xampp\htdocs\codei4\system\helpers\date_helper.php", "PHP", 412, 0, 0, 0, 230, 101, 743
"c:\xampp\htdocs\codei4\system\helpers\directory_helper.php", "PHP", 33, 0, 0, 0, 60, 9, 102
"c:\xampp\htdocs\codei4\system\helpers\download_helper.php", "PHP", 70, 0, 0, 0, 72, 17, 159
"c:\xampp\htdocs\codei4\system\helpers\email_helper.php", "PHP", 16, 0, 0, 0, 63, 6, 85
"c:\xampp\htdocs\codei4\system\helpers\file_helper.php", "PHP", 243, 0, 0, 0, 162, 49, 454
"c:\xampp\htdocs\codei4\system\helpers\form_helper.php", "PHP", 570, 0, 0, 0, 345, 141, 1056
"c:\xampp\htdocs\codei4\system\helpers\html_helper.php", "PHP", 202, 0, 0, 0, 162, 47, 411
"c:\xampp\htdocs\codei4\system\helpers\index.html", "HTML", 0, 9, 0, 0, 0, 3, 12
"c:\xampp\htdocs\codei4\system\helpers\inflector_helper.php", "PHP", 165, 0, 0, 0, 99, 24, 288
"c:\xampp\htdocs\codei4\system\helpers\language_helper.php", "PHP", 14, 0, 0, 0, 56, 6, 76
"c:\xampp\htdocs\codei4\system\helpers\number_helper.php", "PHP", 36, 0, 0, 0, 53, 6, 95
"c:\xampp\htdocs\codei4\system\helpers\path_helper.php", "PHP", 21, 0, 0, 0, 56, 6, 83
"c:\xampp\htdocs\codei4\system\helpers\security_helper.php", "PHP", 41, 0, 0, 0, 84, 13, 138
"c:\xampp\htdocs\codei4\system\helpers\smiley_helper.php", "PHP", 127, 0, 0, 0, 95, 34, 256
"c:\xampp\htdocs\codei4\system\helpers\string_helper.php", "PHP", 119, 0, 0, 0, 160, 26, 305
"c:\xampp\htdocs\codei4\system\helpers\text_helper.php", "PHP", 310, 0, 0, 0, 191, 67, 568
"c:\xampp\htdocs\codei4\system\helpers\typography_helper.php", "PHP", 27, 0, 0, 0, 70, 8, 105
"c:\xampp\htdocs\codei4\system\helpers\url_helper.php", "PHP", 300, 0, 0, 0, 201, 69, 570
"c:\xampp\htdocs\codei4\system\helpers\xml_helper.php", "PHP", 25, 0, 0, 0, 56, 10, 91
"c:\xampp\htdocs\codei4\system\index.html", "HTML", 0, 9, 0, 0, 0, 3, 12
"c:\xampp\htdocs\codei4\system\language\english\calendar_lang.php", "PHP", 47, 0, 0, 0, 36, 2, 85
"c:\xampp\htdocs\codei4\system\language\english\date_lang.php", "PHP", 56, 0, 0, 0, 36, 3, 95
"c:\xampp\htdocs\codei4\system\language\english\db_lang.php", "PHP", 26, 0, 0, 0, 36, 2, 64
"c:\xampp\htdocs\codei4\system\language\english\email_lang.php", "PHP", 21, 0, 0, 0, 36, 2, 59
"c:\xampp\htdocs\codei4\system\language\english\form_validation_lang.php", "PHP", 32, 0, 0, 0, 36, 2, 70
"c:\xampp\htdocs\codei4\system\language\english\ftp_lang.php", "PHP", 14, 0, 0, 0, 36, 2, 52
"c:\xampp\htdocs\codei4\system\language\english\imglib_lang.php", "PHP", 20, 0, 0, 0, 36, 2, 58
"c:\xampp\htdocs\codei4\system\language\english\index.html", "HTML", 0, 9, 0, 0, 0, 3, 12
"c:\xampp\htdocs\codei4\system\language\english\migration_lang.php", "PHP", 10, 0, 0, 0, 36, 2, 48
"c:\xampp\htdocs\codei4\system\language\english\number_lang.php", "PHP", 7, 0, 0, 0, 36, 2, 45
"c:\xampp\htdocs\codei4\system\language\english\pagination_lang.php", "PHP", 6, 0, 0, 0, 36, 2, 44
"c:\xampp\htdocs\codei4\system\language\english\profiler_lang.php", "PHP", 23, 0, 0, 0, 36, 2, 61
"c:\xampp\htdocs\codei4\system\language\english\unit_test_lang.php", "PHP", 21, 0, 0, 0, 36, 2, 59
"c:\xampp\htdocs\codei4\system\language\english\upload_lang.php", "PHP", 18, 0, 0, 0, 36, 2, 56
"c:\xampp\htdocs\codei4\system\language\index.html", "HTML", 0, 9, 0, 0, 0, 3, 12
"c:\xampp\htdocs\codei4\system\libraries\Cache\Cache.php", "PHP", 76, 0, 0, 0, 151, 29, 256
"c:\xampp\htdocs\codei4\system\libraries\Cache\drivers\Cache_apc.php", "PHP", 68, 0, 0, 0, 124, 26, 218
"c:\xampp\htdocs\codei4\system\libraries\Cache\drivers\Cache_dummy.php", "PHP", 40, 0, 0, 0, 113, 20, 173
"c:\xampp\htdocs\codei4\system\libraries\Cache\drivers\Cache_file.php", "PHP", 114, 0, 0, 0, 134, 39, 287
"c:\xampp\htdocs\codei4\system\libraries\Cache\drivers\Cache_memcached.php", "PHP", 135, 0, 0, 0, 141, 38, 314
"c:\xampp\htdocs\codei4\system\libraries\Cache\drivers\Cache_redis.php", "PHP", 133, 0, 0, 0, 156, 42, 331
"c:\xampp\htdocs\codei4\system\libraries\Cache\drivers\Cache_wincache.php", "PHP", 65, 0, 0, 0, 127, 26, 218
"c:\xampp\htdocs\codei4\system\libraries\Cache\drivers\index.html", "HTML", 0, 9, 0, 0, 0, 3, 12
"c:\xampp\htdocs\codei4\system\libraries\Cache\index.html", "HTML", 0, 9, 0, 0, 0, 3, 12
"c:\xampp\htdocs\codei4\system\libraries\Calendar.php", "PHP", 202, 0, 0, 0, 286, 59, 547
"c:\xampp\htdocs\codei4\system\libraries\Cart.php", "PHP", 223, 0, 0, 0, 269, 76, 568
"c:\xampp\htdocs\codei4\system\libraries\Driver.php", "PHP", 139, 0, 0, 0, 167, 37, 343
"c:\xampp\htdocs\codei4\system\libraries\Email.php", "PHP", 1274, 0, 0, 0, 826, 391, 2491
"c:\xampp\htdocs\codei4\system\libraries\Encrypt.php", "PHP", 191, 0, 0, 0, 257, 74, 522
"c:\xampp\htdocs\codei4\system\libraries\Encryption.php", "PHP", 530, 0, 0, 0, 301, 111, 942
"c:\xampp\htdocs\codei4\system\libraries\Form_validation.php", "PHP", 749, 0, 0, 0, 644, 206, 1599
"c:\xampp\htdocs\codei4\system\libraries\Ftp.php", "PHP", 284, 0, 0, 0, 286, 98, 668
"c:\xampp\htdocs\codei4\system\libraries\Image_lib.php", "PHP", 935, 0, 0, 0, 660, 248, 1843
"c:\xampp\htdocs\codei4\system\libraries\Javascript.php", "PHP", 271, 0, 0, 0, 482, 104, 857
"c:\xampp\htdocs\codei4\system\libraries\Javascript\Jquery.php", "PHP", 359, 0, 0, 0, 568, 150, 1077
"c:\xampp\htdocs\codei4\system\libraries\Javascript\index.html", "HTML", 0, 9, 0, 0, 0, 3, 12
"c:\xampp\htdocs\codei4\system\libraries\Migration.php", "PHP", 214, 0, 0, 0, 196, 68, 478
"c:\xampp\htdocs\codei4\system\libraries\Pagination.php", "PHP", 278, 0, 0, 0, 327, 100, 705
"c:\xampp\htdocs\codei4\system\libraries\Parser.php", "PHP", 88, 0, 0, 0, 130, 31, 249
"c:\xampp\htdocs\codei4\system\libraries\Profiler.php", "PHP", 325, 0, 0, 0, 169, 81, 575
"c:\xampp\htdocs\codei4\system\libraries\Session\Session.php", "PHP", 540, 0, 0, 0, 309, 135, 984
"c:\xampp\htdocs\codei4\system\libraries\Session\SessionHandlerInterface.php", "PHP", 10, 0, 0, 0, 47, 3, 60
"c:\xampp\htdocs\codei4\system\libraries\Session\Session_driver.php", "PHP", 55, 0, 0, 0, 114, 19, 188
"c:\xampp\htdocs\codei4\system\libraries\Session\drivers\Session_database_driver.php", "PHP", 222, 0, 0, 0, 163, 61, 446
"c:\xampp\htdocs\codei4\system\libraries\Session\drivers\Session_files_driver.php", "PHP", 211, 0, 0, 0, 162, 56, 429
"c:\xampp\htdocs\codei4\system\libraries\Session\drivers\Session_memcached_driver.php", "PHP", 190, 0, 0, 0, 157, 51, 398
"c:\xampp\htdocs\codei4\system\libraries\Session\drivers\Session_redis_driver.php", "PHP", 221, 0, 0, 0, 184, 55, 460
"c:\xampp\htdocs\codei4\system\libraries\Session\drivers\index.html", "HTML", 0, 9, 0, 0, 0, 3, 12
"c:\xampp\htdocs\codei4\system\libraries\Session\index.html", "HTML", 0, 9, 0, 0, 0, 3, 12
"c:\xampp\htdocs\codei4\system\libraries\Table.php", "PHP", 246, 0, 0, 0, 211, 82, 539
"c:\xampp\htdocs\codei4\system\libraries\Trackback.php", "PHP", 259, 0, 0, 0, 218, 80, 557
"c:\xampp\htdocs\codei4\system\libraries\Typography.php", "PHP", 111, 0, 0, 0, 276, 38, 425
"c:\xampp\htdocs\codei4\system\libraries\Unit_test.php", "PHP", 169, 0, 0, 0, 185, 53, 407
"c:\xampp\htdocs\codei4\system\libraries\Upload.php", "PHP", 621, 0, 0, 0, 530, 176, 1327
"c:\xampp\htdocs\codei4\system\libraries\User_agent.php", "PHP", 292, 0, 0, 0, 293, 97, 682
"c:\xampp\htdocs\codei4\system\libraries\Xmlrpc.php", "PHP", 961, 0, 0, 0, 711, 249, 1921
"c:\xampp\htdocs\codei4\system\libraries\Xmlrpcs.php", "PHP", 335, 0, 0, 0, 185, 100, 620
"c:\xampp\htdocs\codei4\system\libraries\Zip.php", "PHP", 249, 0, 0, 0, 221, 63, 533
"c:\xampp\htdocs\codei4\system\libraries\index.html", "HTML", 0, 9, 0, 0, 0, 3, 12
"Total", "-", 30444, 405, 57, 23, 30244, 8812, 69985